1111111111111111111111111111111111
111111111PC1111111111111111111111
